##############e#
#.###.###....#.#
#.##...#...#.#.#
#....#.#.##....#
##.###...#####.#
#..###.####....#
#####..#########
#####.##########
#####.########.#
#.###.###....#.#
#.##...#...#.#.#
#....#.#.##....#
##.###...#####.#
#..###.####....x
#####..#########
################
