#############
e..#.#...#..#
##.#.##.##.##
#....#..#...x
######.##.###
#...........#
#####.###.###
#...........#
#############
